572, 568
700, 390, 42
804, 566, 05, 7
404, 350, 144, 43, 359
720, 150, 403, 383, 48, 412
359,  39, 159, 143, 32, 368, 39
116, 114, 24, 589, 584, 548, 26, 397
100, 511, 72, 435, 25, 478, 258, 539, 363
150, 150, 370, 43, 25, 47, 25, 53, 36, 33
250, 250, 370, 43, 25, 47, 25, 53, 36, 33, 11
350, 350, 370, 43, 257, 247, 254, 513, 316, 313, 121, 255